OO-T--T-TT-T----}OOOOOOOOOOOOOOOOOOO
OOO|OO|O[JO|OOOO|OOOOOOOOOOOOOOOOOOO
|O-X-O|OO|O|OOOO|OOOOOOOOOOOOOOOOOOO
|OO|OO|OOLTJOOE-ZT----T------------D
|OO[T-Z--ZZJOOOOO|OOOO|OOOOOOOOOOOOO
|OOO|OOOOOO|OOOOO|OOOO|OOOOOOOOOOOOO
L---XTT-}OOL-----Z----X------OOOOOOO
|OOOLZ]O|OO|OOOOOOOOOO|OOOOOOOOOOOOO
|OO{]OOO|OOL----OOOOAO|OOOOOOOOOOOOO
|OO|OOOO|OO|OOOOOOOO|O[T----T------D
L--JOOOO[--XTTT}OOOO|OO|OOOO|OOOOOOO
|OO|OOOOOOOLZZZZ----JOO|OOOO|OOOOOOO
|OO|OOOOOOO|OOOOOOOO|OO|OOOO|OOOOOOO
|OO|OOOOOOO|OOOOOOOO|OO|OOOO|OOOOOOO
|OO[-T--}OO|OOOOOOOOL--]OOOO|OOOOOOO
|OOOO|OO|OO|OOOOOOOO|OOOOO{-]OOOOOOO
[----]OO[--X-------TZ-----]OOOOOOOOO
OOOOOOOOOOO|OOOOOOO|OOOOOOOOOOOOOOOO
OOOOOOOOOOO|OOOOOOO|OOOOOOOOOOOOOOOO
OOOOOOOOOOO[----T--JOOOOOOOOOOOOOOOO
OOOOOOOOOOOOOOOO|OO|OOOOOOOOOOOOOOOO
OOOOOOOOOOOOOOOO|OO|OOOOOOOOOOOOOOOO
OOOOOOOOOOOOOOOO|O{]OOOOOOOOOOOOOOOO
OOOOOOOOOOOOOOOO[-]OOOOOOOOOOOOOOOOO
OOOOOOOOOOOOOOOOOOOOOOOOOOOOOOOOOOOO
OOOOOOOOOOOOOOOOOOOOOOOOOOOOOOOOOOOO
OOOOOOOOOOOOOOOOOOOOOOOOOOOOOOOOOOOO
OOOOOOOOOOOOOOOOOOOOOOOOOOOOOOOOOOOO
OOOOOOOOOOOOOOOOOOOOOOOOOOOOOOOOOOOO
OOOOOOOOOOOOOOOOOOOOOOOOOOOOOOOOOOOO
OOOOOOOOOOOOOOOOOOOOOOOOOOOOOOOOOOOO
OOOOOOOOOOOOOOOOOOOOOOOOOOOOOOOOOOOO
OOOOOOOOOOOOOOOOOOOOOOOOOOOOOOOOOOOO
OOOOOOOOOOOOOOOOOOOOOOOOOOOOOOOOOOOO
OOOOOOOOOOOOOOOOOOOOOOOOOOOOOOOOOOOO
