OOOOOOOOOOOOOOOOOOOOOOOOOOOOOOOOOOOOOOOOOOOOOOOO
OOOOOOOO-}OAOOOOOOOOOOOOOOOOOOOOOOOOOOOOOOOOOOOO
OO-T-OOOO|O|OOOOOOOOOOOOOOOOOOOOOOOOOOOOOOOOOOOO
OOO|OOOOOLTJOOE--T----T---------------}OOOOOOOOO
OOO[T----ZZJOOOOO|OOOO|OOOOOOOOOOOOOOO|OOOOOOOOO
OOOO|OOOOOO|OOOOO|OOOO|OOOOOOOOOOOOOOO|OOOOOOOOO
OOOOLTT-}OOL-----Z----X------OOOOOOOOO|OOOOOOOOO
OOOOLZ]O|OO|OOOOOOOOOO|OOOOOOOOOOOOOOO|OOOOOOOOO
OOO{]OOO|OOL----OOOOAO|OOOOOOOOOOOOOOO|OOOOOOOOO
OOO|OOOO|OO|OOOOOOOO|O[T----T---------Z---DOOOOO
OOO|OOOO[--XTTT}OOOO|OO|OOOO|OOOOOOOOOOOOOOOOOOO
OOO|OOOOOOOLZZZZ----JOO|OOOO|OOOOOOOOOOOOOOOOOOO
OOO|OOOOOOO|OOOOOOOO|OO|OOOO|OOOOOOOOOOOOOOOOOOO
OOO|OOOOOOO|OOOOOOOO|OO|OOOO|OOOOOOOOOOOOOOOOOOO
OOO[----}OO|OOOOOOOOL--]OOOO|OOOOOOOOOOOOOOOOOOO
OOOOOOOO|OO|OOOOOOOO|OOOOO{-]OOOOOOOOOOOOOOOOOOO
OOOOOOOO[--Z--------Z-----]OOOOOOOOOOOOOOOOOOOOO
OOOOOOOOOOOOOOOOOOOOOOOOOOOOOOOOOOOOOOOOOOOOOOOO
OOOOOOOOOOOOOOOOOOOOOOOOOOOOOOOOOOOOOOOOOOOOOOOO
OOOOOOOOOOOOOOOOOOOOOOOOOOOOOOOOOOOOOOOOOOOOOOOO
OOOOOOOOOOOOOOOOOOOOOOOOOOOOOOOOOOOOOOOOOOOOOOOO
OOOOOOOOOOOOOOOOOOOOOOOOOOOOOOOOOOOOOOOOOOOOOOOO
OOOOOOOOOOOOOOOOOOOOOOOOOOOOOOOOOOOOOOOOOOOOOOOO
OOOOOOOOOOOOOOOOOOOOOOOOOOOOOOOOOOOOOOOOOOOOOOOO
OOOOOOOOOOOOOOOOOOOOOOOOOOOOOOOOOOOOOOOOOOOOOOOO
OOOOOOOOOOOOOOOOOOOOOOOOOOOOOOOOOOOOOOOOOOOOOOOO
OOOOOOOOOOOOOOOOOOOOOOOOOOOOOOOOOOOOOOOOOOOOOOOO
OOOOOOOOOOOOOOOOOOOOOOOOOOOOOOOOOOOOOOOOOOOOOOOO
OOOOOOOOOOOOOOOOOOOOOOOOOOOOOOOOOOOOOOOOOOOOOOOO
OOOOOOOOOOOOOOOOOOOOOOOOOOOOOOOOOOOOOOOOOOOOOOOO
OOOOOOOOOOOOOOOOOOOOOOOOOOOOOOOOOOOOOOOOOOOOOOOO
OOOOOOOOOOOOOOOOOOOOOOOOOOOOOOOOOOOOOOOOOOOOOOOO
OOOOOOOOOOOOOOOOOOOOOOOOOOOOOOOOOOOOOOOOOOOOOOOO
OOOOOOOOOOOOOOOOOOOOOOOOOOOOOOOOOOOOOOOOOOOOOOOO
OOOOOOOOOOOOOOOOOOOOOOOOOOOOOOOOOOOOOOOOOOOOOOOO
OOOOOOOOOOOOOOOOOOOOOOOOOOOOOOOOOOOOOOOOOOOOOOOO
OOOOOOOOOOOOOOOOOOOOOOOOOOOOOOOOOOOOOOOOOOOOOOOO
OOOOOOOOOOOOOOOOOOOOOOOOOOOOOOOOOOOOOOOOOOOOOOOO
OOOOOOOOOOOOOOOOOOOOOOOOOOOOOOOOOOOOOOOOOOOOOOOO
OOOOOOOOOOOOOOOOOOOOOOOOOOOOOOOOOOOOOOOOOOOOOOOO
OOOOOOOOOOOOOOOOOOOOOOOOOOOOOOOOOOOOOOOOOOOOOOOO
OOOOOOOOOOOOOOOOOOOOOOOOOOOOOOOOOOOOOOOOOOOOOOOO
OOOOOOOOOOOOOOOOOOOOOOOOOOOOOOOOOOOOOOOOOOOOOOOO
OOOOOOOOOOOOOOOOOOOOOOOOOOOOOOOOOOOOOOOOOOOOOOOO
OOOOOOOOOOOOOOOOOOOOOOOOOOOOOOOOOOOOOOOOOOOOOOOO
OOOOOOOOOOOOOOOOOOOOOOOOOOOOOOOOOOOOOOOOOOOOOOOO
OOOOOOOOOOOOOOOOOOOOOOOOOOOOOOOOOOOOOOOOOOOOOOOO
OOOOOOOOOOOOOOOOOOOOOOOOOOOOOOOOOOOOOOOOOOOOOOOO
