OO-T--T-TT-T----}OOOOOOOOOOOOOOOOOOOOOOOOOOOOOOO
OOO|OO|O[JO|OOOO|OOOOOOOOOOOOOOOOOOOOOOOOOOOOOOO
OO-X-O|OO|O|OOOO|OOOOOOOOOOOOOOOOOOOOOOOOOOOOOOO
|OO|OO|OOLTJOOE-ZT----T---------------}OOOOOOOOO
|OO[T-Z--ZZJOOOOO|OOOO|OOOOOOOOOOOOOOO|OOOOOOOOO
|OOO|OOOOOO|OOOOO|OOOO|OOOOOOOOOOOOOOO|OOOOOOOOO
|OOOLTT-}OOL-----Z----X------OOOOOOOOO|OOOOOOOOO
|OOOLZ]O|OO|OOOOOOOOOO|OOOOOOOOOOOOOOO|OOOOOOOOO
|OO{]OOO|OOL----OOOOAO|OOOOOOOOOOOOOOO|OOOOOOOOO
|OO|OOOO|OO|OOOOOOOO|O[T----T---------Z---DOOOOO
[--JOOOO[--XTTT}OOOO|OO|OOOO|OOOOOOOOOOOOOOOOOOO
OOO|OOOOOOOLZZZZ----JOO|OOOO|OOOOOOOOOOOOOOOOOOO
OOO|OOOOOOO|OOOOOOOO|OO|OOOO|OOOOOOOOOOOOOOOOOOO
OOO|OOOOOOO|OOOOOOOO|OO|OOOO|OOOOOOOOOOOOOOOOOOO
OOO[----}OO|OOOOOOOOL--]OOOO|OOOOOOOOOOOOOOOOOOO
OOOOOOOO|OO|OOOOOOOO|OOOOO{-]OOOOOOOOOOOOOOOOOOO
OOOOOOOO[--X-------TZ-----]OOOOOOOOOOOOOOOOOOOOO
OOOOOOOOOOO|OOOOOOO|OOOOOOOOOOOOOOOOOOOOOOOOOOOO
OOOOOOOOOOO|OOOOOOO|OOOOOOOOOOOOOOOOOOOOOOOOOOOO
OOOOOOOOOOO[----T--JOOOOOOOOOOOOOOOOOOOOOOOOOOOO
OOOOOOOOOOOOOOOO|OO|OOOOOOOOOOOOOOOOOOOOOOOOOOOO
OOOOOOOOOOOOOOOO|OO|OOOOOOOOOOOOOOOOOOOOOOOOOOOO
OOOOOOOOOOOOOOOO|O{]OOOOOOOOOOOOOOOOOOOOOOOOOOOO
OOOOOOOOOOOOOOOO[-]OOOOOOOOOOOOOOOOOOOOOOOOOOOOO
OOOOOOOOOOOOOOOOOOOOOOOOOOOOOOOOOOOOOOOOOOOOOOOO
OOOOOOOOOOOOOOOOOOOOOOOOOOOOOOOOOOOOOOOOOOOOOOOO
OOOOOOOOOOOOOOOOOOOOOOOOOOOOOOOOOOOOOOOOOOOOOOOO
OOOOOOOOOOOOOOOOOOOOOOOOOOOOOOOOOOOOOOOOOOOOOOOO
OOOOOOOOOOOOOOOOOOOOOOOOOOOOOOOOOOOOOOOOOOOOOOOO
OOOOOOOOOOOOOOOOOOOOOOOOOOOOOOOOOOOOOOOOOOOOOOOO
OOOOOOOOOOOOOOOOOOOOOOOOOOOOOOOOOOOOOOOOOOOOOOOO
OOOOOOOOOOOOOOOOOOOOOOOOOOOOOOOOOOOOOOOOOOOOOOOO
OOOOOOOOOOOOOOOOOOOOOOOOOOOOOOOOOOOOOOOOOOOOOOOO
OOOOOOOOOOOOOOOOOOOOOOOOOOOOOOOOOOOOOOOOOOOOOOOO
OOOOOOOOOOOOOOOOOOOOOOOOOOOOOOOOOOOOOOOOOOOOOOOO
OOOOOOOOOOOOOOOOOOOOOOOOOOOOOOOOOOOOOOOOOOOOOOOO
OOOOOOOOOOOOOOOOOOOOOOOOOOOOOOOOOOOOOOOOOOOOOOOO
OOOOOOOOOOOOOOOOOOOOOOOOOOOOOOOOOOOOOOOOOOOOOOOO
OOOOOOOOOOOOOOOOOOOOOOOOOOOOOOOOOOOOOOOOOOOOOOOO
OOOOOOOOOOOOOOOOOOOOOOOOOOOOOOOOOOOOOOOOOOOOOOOO
OOOOOOOOOOOOOOOOOOOOOOOOOOOOOOOOOOOOOOOOOOOOOOOO
OOOOOOOOOOOOOOOOOOOOOOOOOOOOOOOOOOOOOOOOOOOOOOOO
OOOOOOOOOOOOOOOOOOOOOOOOOOOOOOOOOOOOOOOOOOOOOOOO
OOOOOOOOOOOOOOOOOOOOOOOOOOOOOOOOOOOOOOOOOOOOOOOO
OOOOOOOOOOOOOOOOOOOOOOOOOOOOOOOOOOOOOOOOOOOOOOOO
OOOOOOOOOOOOOOOOOOOOOOOOOOOOOOOOOOOOOOOOOOOOOOOO
OOOOOOOOOOOOOOOOOOOOOOOOOOOOOOOOOOOOOOOOOOOOOOOO
OOOOOOOOOOOOOOOOOOOOOOOOOOOOOOOOOOOOOOOOOOOOOOOO
